{
    "605": "g",
    "606": "g",
    "646": "g",
    "645": "g",
    "269": "g",
    "291": "g",
    "203": "g",
    "204": "g",
    "205": "g",
    "208": "kCal",
    "307": "mg",
    "268": "kJ",
    "859": "g",
    "829": "g",
    "868": "g",
    "869": "g"
}