{
    "605": "g",
    "829": "g",
    "868": "g",
    "606": "g",
    "645": "g",
    "269": "g",
    "869": "g",
    "646": "g",
    "203": "g",
    "204": "g",
    "291": "g",
    "205": "g",
    "307": "mg",
    "859": "g"
}